********#####************
*************************
****************######***
*************************
#************************
#************************
#**********#*************
***********#*************
***********#*************
***********#*************
***********#*************
*************************
*************************
****#*******************#
****#*******************#
****#*******************#
****#*******************#
****#*******************#
*************************
*************************
***####******************
*************************
*************************
*************************
*************######******